24 30
29 21 21 21 21 21 21 21 21 21 21 21 21 21 21 21 21 21 21 21 21 21 21 30
23 16 16 16 16 16 16 16 16 16 16 16 16 16 16 16 16 16 16 16 16 16 16 24
23 16 18 18 18 18 18 18 18 18 18 18 18 18 18 18 18 18 18 18 18 18 16 24
23 16 26 33 0 0 0 0 0 0 0 0 0 0 0 0 0 0 0 0 0 0 19 24
23 16 28 15 3 3 3 3 14 25 17 17 17 26 15 3 3 3 14 25 26 0 19 24
23 16 26 3 3 3 3 3 3 19 16 16 16 20 3 3 3 3 3 27 28 0 19 24
23 16 28 3 3 3 3 3 3 19 16 16 16 20 3 3 3 3 3 14 12 0 19 24
23 16 26 3 3 3 3 3 6 27 18 18 18 28 13 3 3 3 3 3 12 0 19 24
23 16 20 3 3 3 3 3 0 1 0 0 0 0 1 13 3 3 3 3 12 0 19 24
23 16 20 3 12 1 1 1 0 0 1 1 1 1 1 1 1 13 3 3 12 0 19 24
23 16 20 3 12 1 0 0 0 0 0 1 1 1 1 0 0 0 13 3 12 0 19 24
23 16 20 3 6 0 0 0 0 0 0 0 0 1 0 0 1 0 0 3 12 0 19 24
23 16 28 3 6 0 1 0 0 1 0 0 0 0 0 1 1 0 0 3 12 0 19 24
23 16 26 3 6 1 0 0 0 1 1 0 0 0 1 1 1 1 0 3 12 0 19 24
23 16 28 3 6 1 1 1 0 1 0 0 0 0 0 0 0 0 0 3 12 0 19 24
23 20 1 3 6 1 0 1 0 1 0 0 0 1 0 0 0 0 0 3 12 0 19 24
23 20 1 3 6 0 1 0 0 0 0 1 1 1 15 4 14 0 0 3 12 0 19 24
23 20 1 3 6 0 1 1 0 0 1 1 0 1 2 2 2 14 15 3 12 0 19 24
23 20 0 3 6 1 0 1 1 1 1 0 0 15 3 3 3 3 3 3 12 0 19 24
23 20 0 3 6 1 0 1 1 1 0 0 15 3 3 3 3 3 3 3 12 0 19 24
23 20 0 3 14 0 1 0 0 0 0 0 3 3 3 3 3 3 3 3 12 0 19 24
23 20 0 3 3 14 1 1 1 1 0 0 3 3 2 2 2 2 2 2 12 0 19 24
23 20 0 3 3 3 14 0 0 0 0 15 3 3 2 2 2 2 2 2 12 0 19 24
23 20 0 3 3 3 3 3 3 3 3 3 3 3 2 2 2 2 2 2 12 0 19 24
23 20 15 3 3 3 3 3 3 3 3 3 3 3 2 2 2 2 2 2 12 0 19 24
23 20 13 10 3 3 3 3 3 3 3 3 3 3 2 2 2 2 2 2 0 0 19 24
23 20 0 0 0 0 0 0 0 0 0 0 0 0 0 0 0 0 0 0 0 0 19 24
23 20 25 26 25 26 25 26 25 26 25 26 25 26 25 26 25 26 25 26 25 26 16 24
23 16 16 16 16 16 16 16 16 16 16 16 16 16 16 16 16 16 16 16 16 16 16 24
31 22 22 22 22 22 22 22 22 22 22 22 22 22 22 22 22 22 22 22 22 22 22 32