24 30
29 21 21 21 21 21 21 21 21 21 21 21 21 21 21 21 21 21 21 21 21 21 21 30
23 16 16 16 16 16 16 16 16 16 16 16 16 16 16 16 16 16 16 16 16 16 16 24
23 16 16 16 16 16 16 16 16 16 16 16 16 16 16 16 16 16 16 16 16 16 16 24
23 16 16 16 16 16 16 16 16 16 16 16 16 16 16 16 16 16 16 16 16 16 16 24
23 16 16 16 16 16 16 16 16 16 16 16 16 16 16 16 16 16 16 16 16 16 16 24
23 16 16 16 16 16 16 16 16 16 16 16 16 16 16 16 16 16 16 16 16 16 16 24
23 16 16 16 16 16 16 16 16 16 16 16 16 16 16 16 16 16 16 16 16 16 16 24
23 16 16 16 16 16 16 16 16 16 16 16 16 16 16 16 16 16 16 16 16 16 16 24
23 16 16 16 16 16 16 16 16 16 16 16 16 16 16 16 16 16 16 16 16 16 16 24
23 16 16 16 16 16 16 16 16 16 16 16 16 16 16 16 16 16 16 16 16 16 16 24
23 16 16 16 16 16 16 16 16 16 16 16 16 16 16 16 16 16 16 16 16 16 16 24
23 16 16 16 16 16 16 16 16 16 16 16 16 16 16 16 16 16 16 16 16 16 16 16
23 16 16 16 16 16 16 16 16 16 16 16 16 16 16 16 16 16 16 16 16 16 16 24
23 16 16 16 16 16 16 16 16 16 16 16 16 16 16 16 16 16 16 16 16 16 16 16
23 16 16 16 16 16 16 16 16 16 16 16 16 16 16 16 16 16 16 16 16 16 16 24
23 16 16 16 16 16 16 16 16 16 16 16 16 16 16 16 16 16 16 16 16 16 16 24
23 16 16 16 16 16 16 16 16 16 16 16 16 16 16 16 16 16 16 16 16 16 16 24
23 16 16 16 16 16 16 16 16 16 16 16 16 16 16 16 16 16 16 16 16 16 16 24
23 16 18 18 18 18 18 18 18 18 18 18 16 16 22 22 22 22 22 22 22 22 16 24
23 20 0 3 6 1 0 1 1 1 0 0 27 28 3 3 3 3 3 3 12 0 31 16
23 20 0 3 14 0 1 0 0 0 0 0 3 3 3 3 3 3 3 3 12 0 3 23
23 20 0 3 3 14 1 1 1 1 0 0 3 3 2 2 2 2 2 2 12 0 29 16
23 16 17 21 21 17 17 17 26 0 0 15 3 3 2 29 30 2 2 2 12 0 19 24
23 16 16 16 16 16 16 16 24 3 3 3 3 3 2 31 32 2 2 2 12 0 19 24
23 16 16 16 16 16 16 16 24 3 3 3 3 3 3 3 25 17 17 17 17 17 16 24
23 16 16 16 16 16 16 16 20 3 2 3 3 2 3 3 19 16 16 16 16 16 16 24
23 16 16 16 16 16 16 16 20 3 2 2 2 2 2 3 19 16 16 16 16 16 16 24
23 16 16 16 16 16 16 16 20 3 3 3 3 2 2 2 19 16 16 16 16 16 16 24
23 16 16 16 16 16 16 16 16 17 17 17 17 17 17 17 16 16 16 16 16 16 16 24
31 22 22 22 22 22 22 22 22 22 22 22 22 22 22 22 22 22 22 22 22 22 22 32