17 13
33 27 18 18 18 18 28 0 16 16 16 16 16 16 16 22 21
26 15 4 4 4 4 14 25 16 15 15 15 15 15 14 9 5
20 7 2 2 2 3 6 19 16 14 14 14 14 14 14 9 5
20 7 2 3 2 3 6 19 16 3 3 3 12 14 14 9 5
28 13 5 5 5 5 12 27 16 3 3 3 3 15 14 9 5
0 25 17 17 17 17 26 0 16 1 26 3 3 15 14 9 5
16 16 16 16 16 16 16 16 16 3 1 3 3 14 14 9 5
28 25 17 17 17 17 17 26 27 1 1 3 3 15 14 1 5
6 0 15 14 10 1 3 3 3 3 3 3 3 15 14 1 5
6 0 15 15 14 14 14 14 14 14 14 14 14 15 14 1 5
6 0 15 15 15 14 14 15 15 15 15 15 15 14 14 10 5
22 0 8 8 8 8 8 8 8 8 8 8 8 8 8 2 17
18 23 23 23 23 23 23 23 23 23 23 23 23 23 23 23 19